███████████S
+─────────d┐
           |
W──┐ ┌───┐ |
   ├─┤   ├─┘
W──┘ └┐ ┌┘
      ├─┤
W─────┘ └──┐
 zXXXXXXx──┘